000000000000000000
L0000000000000000B
000000011100000000
000000111110000000
000000200022000000
000000200022000000
000000333330000000
000000333330000000
000000444444000000
000000400004000000
000000500005000000
000000555555000000
000000555550000000
B0000000000000000S
