000000000000000000
000000000000000000
000000000000000000
000000000000000000
000000000000000000
000B11111111111000
000S2222222222B000
000333333333333000
0004444444S4444000
000555555555555000
