000000000000000000
000000000000000000
000000000000000000
000000000000000000
000000000000000000
111111111000000000
002222222220000000
000033333333300000
000000444444444000
000000005555555555
