000000000000000000
000000000000000000
000000000000000000
000000000000000000
000000000000000000
11111111111B11111L
222S22222222222222
3L3333333333333333
4444444444S4444444
BBBBBBBBBBBBBBBBBB
