000000000000000000
000000000000000000
000000000000000000
000000000000000000
000000000000000000
000000000000000000
000000000000000000
000000000000000000
111111111110000000
222222222220000000
333333333330000000
444444444440000000
555555555550000000
