000000000000000000
000000000000000000
000000000000000000
000000000000000000
000000000000000000
11111111111111111L
222S22222222222222
3L3333333333333333
4444444444S4444444
555555555555555555
