000000000000000000
000000000000000000
000000000000000000
000000000000000000
000000000000000000
11111111111B11111L
2B2S22222222222222
3L333333333333B333
444B444444S4444444
555555555555555555
