000000000000000000
000000000000000000
000000000000000000
000000000000000000
000000000000000000
111B1111111111111L
222S2222222222B222
3L3333333333333333
4444444444S4444444
55B555555555555555
